# # # # # # , , # # # # # #
# . . . . . . . . . . . . #
# . . ===== . . . ===== . #
# . $ |_d_| . . $ |_d_| . #
# . . . . . . . . . . . . #
# . . m . . . . . . . . . #
# . ======$ . . ======= . #
# . . . . . . . |     | . #
# . . . . . . . |___d_| . #
# . . . . . . . . . . . . #
# . ~ ~ ~ . . ======$== . #
# . ~ ~ ~ . . . . . . . . #
# . ~ ~ ~ . . . . . . . . #
# # ~ ~ ~ # # # # # # # # #
