# # # # # # , , # # # # # #
# . . . . . . . . . . . . #
# ----------- | * * * * * #
# . . . . . . | * * * * * #
# . . . T . . | * * * * * #
# . . . . . . | . . . . . #
# ----------------- * * * #
# . . f . . . . . . * * * #
# . . . . . . . . . * * * #
# ----- . ----$ . ------- #
# . . . . . . . . . . . . #
# . . . . . * * . . . . . #
# . . . . . * * . . . . . #
# # # # # # , , # # # # # #
